NO img/nord
SO img/sud
WE img/west
EA img/east

F 210,100,0
C 210,30,0

11111111111111
10000000000001
10111001111001
101 1001  1001
10111001111001
10000000000001
1000000N000001
10000000000001
11111111111111
