NO /home/oklimov/core/common_core/Cub3D/maps/textures/exit0.xpm
SO ./../maps/textures/exit1.xpm
WE maps/textures/exit2.xpm
EA ../../maps/textures/exit3.xpm

F 210,100,20
C 210,30,10

11111111111111
10000000000001
10111001111001
101 1001  1001
10111001111001
10000000000001
1000000N000001
10000000000001
11111111111111
