NO maps/textures/exit0.xpm
SO maps/textures/floor.xpm
WE maps/textures/peppa1.xpm
EA maps/textures/wall.xpm

F 210,100,20
C 210,30,10

      1111111 1111
    1110 000000001
111110011110000001
101 1001  10011111
10111111111111
10000000000001
1W0000000000111
10000000000001
11111111111111
