NO maps/textures/exit0.xpm
SO maps/textures/floor.xpm
WE maps/textures/peppa1.xpm
EA maps/textures/wall.xpm

F 210,100,20
C 210,30,10

      111111111111
    11100000000001
111110011110000001
101 1001  10011111
10111001111001
10000000000001
1W00000000000111
10000000000001
11111111111111
