NO img/nord
SO img/sud
WE img/west
EA img/east

F 210,100,20
C 210,30,10

11111111111111
