NO maps/textures/exit0.xpm
SO maps/textures/floor.xpm
WE maps/textures/peppa1.xpm
EA maps/textures/wall.xpm

F 210,100,20
C 210,30,10

11111
10N01
10001
11N11