111111111111111
1E100C11CC11C01
101011111011101
100000000000001
111111100011111
10000010001C001
10110P100011101
100111100000001
110000000001001
111111111111111
