1111111111111111111111111111111111111
10000000101C0000000000000C10100000001
1011111010111101110111011110101111101
101C00101010000000000000001010100C101
1011101010101111011101111010101011101
1000001000101C000000000C1010001000001
1111111110001011110111101000111111111
100000000010101C00000C101010000000001
1C111111101000101101101000101111111C1
10001000101010101E0010101010100010001
111C10101000100000P00000100010101C111
1000101010101010100010101010101010001
1C111010101000101101101000101010111C1
100000100010101C00000C101010001000001
1111111110001011110111101000111111111
1000001000101C000000000C1010001000001
1011101010101111011101111010101011101
101C00101010000000000000001010100C101
1011111010111101110111011110101111101
1000000C101C0000000000000C10100000001
1111111111111111111111111111111111111
