11111111111111111111111111111111111111111111111111111111111
1P100010001000100010001000100010001000100010001000100010001
10101010101010101010101010101010101010101010101010101010101
10101010101010101010101010101010101010101010101010101010101
10101010101010101010101010101010101010101010101010101010101
10101010101010101010101010101010101010101010101010101010101
10101010101010101010101010101010101010101010101010101010101
10101010101010101010101010101010101010101010101010101010101
10101010101010101010101010101010101010101010101010101010101
10101010101010101010101010101010101010101010101010101010101
10101010101010101010101010101010101010101010101010101010101
10101010101010101010101010101010101010101010101010101010101
10101010101010101010101010101010101010101010101010101010101
10101010101010101010101010101010101010101010101010101010101
10101010101010101010101010101010101010101010101010101010101
10101010101010101010101010101010101010101010101010101010101
10101010101010101010101010101010101010101010101010101010101
10101010101010101010101010101010101010101010101010101010101
10101010101010101010101010101010101010101010101010101010101
10101010101010101010101010101010101010101010101010101010101
10101010101010101010101010101010101010101010101010101010101
10101010101010101010101010101010101010101010101010101010101
10101010101010101010101010101010101010101010101010101010101
10101010101010101010101010101010101010101010101010101010101
10101010101010101010101010101010101010101010101010101010101
10101010101010101010101010101010101010101010101010101010101
10101010101010101010101010101010101010101010101010101010101
10101010101010101010101010101010101010101010101010101010101
10101010101010101010101010101010101010101010101010101010101
1E0010001000100010001000100010001000100010001000100010001C1
11111111111111111111111111111111111111111111111111111111111
