111111
100CP1
1E0001
111111
